Escenario
**************************************
M - Cambia modo de poligonos
N - Cambia modo de poligonos
B - Cambia modo de poligonos

Modos de camara
**************************************
C - Cambiar modo de camara
 
Modo espectador, permite moverse libremente a traves
del escenario
Modo tercerapersona, se posiciona en tercera persona
con el personaje animado

Movimiento de camara
**************************************
W - movimiento de camara hacia adelante
S - movimiento de camara hacia atras
A - movimiento de camara a la izquierda
D - movimiento de camara a la derecha
barra de espacio - movimiento de camara hacia arriba
Shift izquiedo - movimiento de camara hacia abajo
Flecha arriba - rota camara hacia arriba
Flecha abajo - rota camara hacia abajo
Flecha izquierda - rota camara hacia izquierda
Flecha derecha - rota camara hacia derecha


Interacciones
*********************************
X - aumenta la intensidad de las luces
Z - disminuye la intensidad de las luces
Q - Empieza el show de luces
E - Termina el show de luces
I - Abre todas las puertas
K - Cierra todas las puertas
P - Abre las ventanas
L - Cierra las ventanas
U - Abre los inodoros
J - Cierra los inodoros
R - Infla el globo
F - Desinfla globo
